11111111111111111111111111111111111111111111111111111111111111111111111111111
10000000000000000111111100000000000000000000000000000000000000000000000001111
10000000000000000111111100000000000000000000000000000000000000000000000001111
10000000000000000111111100000000000000000000000000000000000000000000000001111
