11111111111111111111111111111111111111111111111111111111111111111111111111111111111111111111111111111111111111111111111111111111
11000000000000000000000000000000000000000000000000000000000000000000000000000000000000000000000000000000000000000000000001111111
11000000000000000000000000000000000000000000000000000000000000000000000000000000000000000000000000000000000000000000000001111111
11000000000000000000000000000000000000000000000000000000000000000000000000000000000000000000000000000000000000000000000001111111
11000000000000000000000000000000000000000000000000000000000000000000000000000000000000000000000000000000000000000000000001111111
11000000000000000000000000000000000000000000000000000000000000000000000000000000000000000000000000000000000000000000000001111111
11000000000000000000000000000000000000000000000000000000000000000000000000000000000000000000000000000000000000000000000001111111
11000000000000000000000000000000000000000000000000000000000000000000000000000000000000000000000000000000000000000000000001111111
11000000000000000000000000000000000000000000000000000000000000000000000000000000000000000000000000000000000000000000000001111111
11000000000000000000000000000000000000000000000000000000000000000000000000000000000000000000000000000000000000000000000001111111
11000000000000000000000000000000000000000000000000000000000000000000000000000000000000000000000000000000000000000000000001111111
11000000000000000000000000000000000000000000000000000000000000000000000000000000000000000000000000000000000000000000000001111111
11000000000000000000000000000000000000000000000000000000000000000000000000000000000000000000000000000000000000000000000001111111
11000000000000000000000000000000000000000000000000000000000000000000000000000000000000000000000000000000000000000000000001111111
11000000000000000000000000000000000000000000000000000000000000000000000000000000000000000000000000000000000000000000000001111111
11000000000000000000000000000000000000000000000000000000000000000000000000000000000000000000000000000000000000000000000001111111
